NO ./textures/NO.xpm
SO ./textures/SO.xpm
EA ./textures/EA.xpm
WE ./textures/WE.xpm

C 27,27,27
F 112,112,100

11111111111111
10000000000001
10000000000001
1000000S000001
10000000000001
10000000000001
11111100011111
10000000000001
10000000000001
10000000000001
10000000000001
10000000000001
11111100011111
10000000000001
10000000000001
10000000000001
10000000000001
10000000000001
11111100011111
10000000000001
10000000000001
10000000000001
10000000000001
10000000000001
11111100011111
10000000000001
10000000000001
10000000000001
10000000000001
10000000000001
11111100011111
10000000000001
10000000000001
10000000000001
10000000000001
10000000000001
11111100011111
10000000000001
10000000000001
10000000000001
10000000000001
10000000000001
11111100011111
10000000000001
10000000000001
10000000000001
10000000000001
10000000000001
11111100011111
10000000000001
10000000000001
10000000000001
10000000000001
10000000000001
11111100011111
10000000000001
10000000000001
10000000000001
10000000000001
10000000000001
11111100011111
10000000000001
10000000000001
10000000000001
10000000000001
10000000000001
11111100011111
10000000000001
10000000000001
10000000000001
10000000000001
10000000000001
11111100011111
10000000000001
10000000000001
10000000000001
10000000000001
10000000000001
11111100011111
10000000000001
10000000000001
10000000000001
10000000000001
10000000000001
11111100011111
10000000000001
10000000000001
10000000000001
10000000000001
10000000000001
11111100011111
10000000000001
10000000000001
10000000000001
10000000000001
10000000000001
11111100011111
10000000000001
10000000000001
10000000000001
10000000000001
10000000000001
11111100011111
10000000000001
10000000000001
10000000000001
10000000000001
10000000000001
11111100011111
10000000000001
10000000000001
10000000000001
10000000000001
10000000000001
11111100011111
10000000000001
10000000000001
10000000000001
10000000000001
10000000000001
11111100011111
10000000000001
10000000000001
10000000000001
10000000000001
10000000000001
11111111111111