NO ./textures/NO.xpm
SO ./textures/SO.xpm
EA ./textures/EA.xpm
WE ./textures/WE.xpm

C 154,207,241
F 45,77,99

111111        
1S0001        
100001 1111111
100001 1000001
100001 1000001
10000111000001
10000000000001
11111111111011
          1011
          1001
11111111111101
10000000000001
10000000000001
11111101111111
     1011111 
     100000111    
     111110001    
         11001111111111111111
          1000000000000000001 
          1111111111111110001
                        10001
                        10001
111111111111111111111111100011
100000000000000000000000000001
100111111111111111111111111111
1001
1001111111111111111111111111111111111111111111111111111111111
1001000000000000001000001000001000000000001000000000000000001
1001001001001001001011001111001111111001111111001111111001001
1000001001001001000001001001001000001000000001000000001001001
1001111111111111001001001001001111101111111001001111111001001
1000000001000000001001000001001000000001000000000001000001001
1001111111111111111001111001001111001111111001111111111111001
1001000001000001000001000000000000000000000000001001001000001
1111001111111001111111111111111001111001111111001001001111001
1001000000001001000001001000000001001000001000000000001000001
1001111111001001111001001111001111001111001111001111111111001
1000000000001000000000000000000001001000001001001000000001001
1111001111111111101111111111001111001001111001111111111001111
1000000001001000000000000001001000001000001000000000000000001
1001001111001001111111111111111001111111111111001111111111001
1001000000000000001000001000000000001000001000001001001000001
1111111111001111111001111001111001001111001001001001001111111
1001001000000000001001001000001001001001000001001000001000001
1001001111111111001001001001111111111001111111001011001111001
1000000001000000000001000000000000000001001001000001001000001
1001111001001001111001001111001111001111001001001111111111001
1000001000001001001001001001000001000000000001001000000000001
1111001111111001001111001001001111001111111001001111001111001
1000000001000000001001000001000001000001000000000000000001001
1001111111001001111001111111001111111001001111111001001111001
1000000001001001001000001001000001000001001000001001000001001
1001111111001001001001001001111001111001111111001001111111111
1001000000001000000001000001001001000001000000000001000001001
1111001111111111001111001111001001001001111111111001001001001
1000000000001001001001000001000001001000001001001000001000001
1111111111111001111001001111001111111111001001001111111001111
1000000001001000000000001000000000001001001000001000000001001
1001001111001001111111001001111001001001111001001111001111001
1001000000000001000001000001000001000001000001001001000000001
1111001001111001001001111001111111111101111001001001001111111
1000001000001001001000001000001000000000000001000001000001001
1001111111001111111001101111001111111111111111111111001111001
1001001000001000000001000001001000000000000001000000000000001
1001001001001111001001111111001011111111111111111001001111101
1000001001001000001000000000000000000001000000000001001000001
1111111111111111111111111111111111111111111111111111111000001
                                                      1000001
                                                      1000001
                                                      1000001
                                                      1110111
                                                        111