
C    154,  207,241    
NO        ./textures/NO2.xpm   

SO ./textures/SO2.xpm
F 45, 77,        99       

EA    ./textures/EA2.xpm
WE ./textures/WE2.xpm
11111111
10010001    
10010001
1110S001
10000001        
1111111

        
