
C    154,  207,241    
NO        ./textures/NO2.xpm   

SO ./textures/SO2.xpm
F 45, 77,        99       

EA    ./textures/EA2.xpm
WE ./textures/WE2.xpm
11111111
10000001
10010001
11100001
10000001        
10000001
10000001
1S000001
11111111

        
